# #
 #
# #

###############
#   #     #   #
#  . * *@*  . #
##$##  *$ ##$##
#    #   # $  #
#  #*#####.#  #
# $* #   # .$ #
##   #*.$#   ##
 ###     * ### 
 #  . * * $. # 
 # ## ###.## # 
 #    # #    # 
 ###### ###### 

###  ######  ######  ######  ###
###  ######  ##  ##  ######  ###
###    ##            ######  ###
###  ######  ##  ##  ######  ###
###  ######  ######  ######  ###
   ##########################   
   #       *  $        .    #   
#### @      *  $      .     ####
####         *  $    .      ####
   #          *  $  .       #   
   ##########################   
###  ######  ######  #   ##  ###
###  ######  ######  # # ##  ###
###    ##              ##    ###
###  ######  ######  # ####  ###
###  ######  ######  ######  ###

  #      #
 #   #  #
  # #  #
   # #  #
  #   #  #
 #   #  #
  # #  #
-
##########
#........####
# $$$$$$$#  #
#.$......#  #
# $$$$$$ #  #
#......$+#  #
#$$$$$$$ #  #
#        # ##
##########